000000000000000000000000000000000001000100010000000000000000000000000000000000000000000000000
000000000000000000000000000000000000000000000000000000000000000000000000000000000000000000000
000000000000000000000000000011100000000000000000000000000000000000000000000000000000000000000
000000000000000000000000000000000000000000000000000000011111000000000000000000000000000000000
0000000000000000p0000000000000000000111100000000000000000000000000000000000000000000000000000
000000000000000000000000000000000000000000000000000000000000000000000000000000000000000000000
000000000000000111000000000010001100000000000000000000000000000000000000000000000000000000000
000000000000111111111000000010000000000000000000000000000000000000000000000000000000000000000
000000000011111111111110000010000000000000000000000000000000000000000000000000000000000000000
111111111111111111111111111111111111111111111111111111111112000000000000002111111111111111111
111111111111111111111111111111111111111111111111111111111112000000000000002111111111111111111
111111111111111111111111111111111111111111111111111111111112000000000000002111111111111111111
111111111111111111111111111111111111111111111111111111111112000000000000002111111111111111111
111111111111111111111111111111111111111111111111111111111112000000000000002111111111111111111
111111111111111111111111111111111111111111111111111111111112000000000000002111111111111111111
111111111111111111111111111111111111111111111111111111111112000000000000002111111111111111111
111111111111111111111111111111111111111111111111111111111112000000000000002111111111111111111
111111111111111111111111111111111111111111111111111111111112000000000000002111111111111111111
111111111111111111111111111111111111111111111111111111111112000000000000002111111111111111111
111111111111111111111111111111111111111111111111111111111112000000000000002111111111111111111
111111111111111111111111111111111111111111111111111111111112000000000000002111111111111111111
111111111111111111111111111111111111111111111111111111111112000000000000002111111111111111111
111111111111111111111111111111111111111111111111111111111112000000000000002111111111111111111
111111111111111111111111111111111111111111111111111111111112000000000000002111111111111111111
111111111111111111111111111111111111111111111111111111111112000000000000002111111111111111111
111111111111111111111111111111111111111111111111111111111112000000000000002111111111111111111
111111111111111111111111111112222222222222222222222211111112000000000000002111111111111111111
111111111111111111111111111112000000000000000000000211111112000000000000002111111111111111111
111111111111111111111111111112000010100000000000000211111112000000000000002111111111111111111
111111111111111111111111111112000011100000000000000222222222000000000000002111111111111111111
111111111111111111111111111112000001000000000000000000000000000000000000002111111111111111111
111111111111111111111111111112000000000000000000000000000000000000000000002111111111111111111
111111111111111111111111111112222222222222222222222222222222222222222222222111111111111111111
111111111111111111111111111111111111111111111111111111111111111111111111111111111111111111111
111111111111111111111111111111111111111111111111111111111111111111111111111111111111111111111
111111111111111111111111111111111111111111111111111111111111111111111111111111111111111111111
111111111111111111111111111111111111111111111111111111111111111111111111111111111111111111111
111111111111111111111111111111111111111111111111111111111111111111111111111111111111111111111
111111111111111111111111111111111111111111111111111111111111111111111111111111111111111111111
111111111111111111111111111111111111111111111111111111111111111111111111111111111111111111111
111111111111111111111111111111111111111111111111111111111111111111111111111111111111111111111