00000000000000000000000000000100
00000000000000000000000000000100
00000000000000000000000000000100
00000000000000000000000000000100
00000000000000000000000000000100
00000000000000000000000000000100
10000000000000000000000000000100
10000000000000000000000000000100
10000000000000000000000000000000
10000000000000000000000110000000
100000000000000000e0000000000000
10000000000001111111100000000000
10p00000000010000000100000000000
100000000000000e0000110000000000
11111111111111111111111111111111
11111111111111111111111111111111
11111111111111111111111111111111
11111111111111111111111111111111
11111111111111111111111111111111
11111111111111111111111111111111
11111111111111111111111111111111
11111111111111111111111111111111
11111111111111111111111111111111
11111111111111111111111111111111
11111111111111111111111111111111
