000000000000000000000000000001
000000000000000000000000000001
000000000000000000000000000001
000000000000000000000000000001
000000000000000000000000000001
000000000000000000000000000001
100000000000000000000000000001
100000000000000000000000000001
100000000000000000000000000000
100000000000000000000001100000
100000000000000000e0e000000000
10p00000000001111111100e000000
100000000000100000001000000000
100000000000000e00001100000000
111111111111111111111111111111
111111111111111111111111111111
111111111111111111111111111111
111111111111111111111111111111
111111111111111111111111111111
111111111111111111111111111111
111111111111111111111111111111
111111111111111111111111111111
111111111111111111111111111111
111111111111111111111111111111
111111111111111111111111111111
