0000000000
0000100000
000p100000
0111111100
0000000000
