00000000000000000000000000
00000000000000000000000000
00000000000000000000000000
00000000000000000000000000
00000000000000000000000000
000p0000000000000000020000
00000000000111000022222200
00000111000001000020000200
00000000000001000000000000
11111111111111111122222211
11111111111111111111111111
11111111111111111111111111
11111111111111111111111111
11111111111111111111111111
11111111111111111111111111
