00000000000000000000000000
00000000000000000000000000
00000000000000000000000000
00000000000000000000000000
00000000000000000000000000
000p0000000000000000000000
00000000000000000000000000
00000000000000000000000000
00000000000000000000000000
11111111111111111122222211
