00000000000000000000000000000100111
00000000000000000000000000000100111
00000000000000000000000000000100111
00000000000000000000000000000100111
00000000000000000000000000000100111
00000000000000000000000000000100111
10000000000000000000000000000100111
10000000000000000000000000000100111
10000000000000000000000000000000111
10000000000000000000000110000000111
10000000000000000000000000000000111
10000000000001111111100000000000000
10p00000000010000000100000000000000
10000000000000000000110000000000000
11111111111111111111111111111111111
11111111111111111111111111111111111
11111111111111111111111111111111111
11111111111111111111111111111111111
11111111111111111111111111111111111
11111111111111111111111111111111111
11111111111111111111111111111111111
11111111111111111111111111111111111
11111111111111111111111111111111111
11111111111111111111111111111111111
11111111111111111111111111111111111
