000000000000000000000000000001
000000000000000000000000000001
000000000000000000000000000001
000000000000000000000000000001
000000000000000000000000000001
000000000000000000000000000001
100000000000000000000000000001
100000000000000000000000000001
100000000000000000000000000000
100000000000000000000001100000
100000000000000000e00000000000
100000000000011111111000000000
10p000000000100000001000000000
100000000000000e00001100000000
111111111111111111111111111111
111111111111111111111111111111
111111111111111111111111111111
111111111111111111111111111111
111111111111111111111111111111
111111111111111111111111111111
111111111111111111111111111111
111111111111111111111111111111
111111111111111111111111111111
111111111111111111111111111111
111111111111111111111111111111
