00p0000000
0000100000
0000100000
0111111100
0000000000
