10000000000000000000000000000000000000000000000000000000000000000000000000000
10000000000000000100000000000000000000000000000000000000000000000000000000000
10000000000000000000000000000000000000000000000000000000000000000000000000000
10000001111000000000000000000000000000000000000000000000000000000000000000000
10000000000000000000000000000000000000000000000000000000000000000000000000000
10000000000000100000000000000000000000000000000000000000000000000000000000000
10000000000000000000000000001110000000000000000000000000000000000000000000000
100p0000000100000022200000000000000000000000000000000000000000000000000000000
10000000100000000000000000000000000000000000000000000000000000000000000000000
11111111111111111122222211111111111111112222222222222221111111212121212121212
11111111111111111111122222222222222222221111111111111111111111111111111111111
22222222111111111111111111111111111122222222222222222222211111111111111111111
22222221111111111111111111111111111111111111111111111111111111111111111111111