0000000000000000000000000000010000000
0000000000000000000000000000010000000
0000000000000000000000000000010000000
0000000000000000000000000000010000000
0000000000000000000000000000010000000
0000000000000000000000000000010000000
1000000000000000000000000000010000000
1000000000000000000000000000010000000
10000000000000000000000e0000000000000
1000000000000000000000011000000000000
1000000000000000000000000000000000000
1000000000000000000000000000000000000
10p000000000000000001e000000000000000
1000000000000000000011000000000000000
1111111111111111111111111111111111111
1111111111111111111111111111111111111
1111111111111111111111111111111111111
1111111111111111111111111111111111111
1111111111111111111111111111111111111
1111111111111111111111111111111111111
1111111111111111111111111111111111111
1111111111111111111111111111111111111
1111111111111111111111111111111111111
1111111111111111111111111111111111111
1111111111111111111111111111111111111
