000000000000000000000000000001
000000000000000000000000000001
000000000000000000000000000001
000000000000000000000000000001
000000000000000000000000000001
000000000000000000000000000001
000000000000000000000000000001
000000000000000000000000000001
000000000000000000000000000000
000000000000000000000001100000
000000000000000000000000000000
000000000000011111111000000000
p00000000000110000001000000000
000000000000000e00001100000000
111111111111111111111111111111
111111111111111111111111111111
111111111111111111111111111111
111111111111111111111111111111
111111111111111111111111111111
111111111111111111111111111111
111111111111111111111111111111
111111111111111111111111111111
111111111111111111111111111111
111111111111111111111111111111
111111111111111111111111111111
