0000000000000000000000000000010000000
0000000000000000000000000000010000000
0000000000000000000000000000010000000
0000000000000000000000000000010000000
0000000000000000000000000000010000000
0000000000000000000000000000010000000
1000000000000000000000000000010000000
1000000000000000000000000000010000000
1000000000000000000000000000000000000
1000000000000000000000011000000000000
100000000000000000e000000000000000000
1000000000000111111110000000000000000
10p0000000001000000010000000000000000
100000000000000e000011000000000000000
1111111111111111111111111111111111111
1111111111111111111111111111111111111
1111111111111111111111111111111111111
1111111111111111111111111111111111111
1111111111111111111111111111111111111
1111111111111111111111111111111111111
1111111111111111111111111111111111111
1111111111111111111111111111111111111
1111111111111111111111111111111111111
1111111111111111111111111111111111111
1111111111111111111111111111111111111
