00p000000000000
000110010001110
001011111001110
001100010001110
000000000000000
