0000000000
0000000000
0000011000
0p00000000
0000000001
1111111111
1111111111
1111111111
1111111111
1111111111