00000000000000000000000000000110
00000000000000000000000000000110
00000000000000000000000000000110
00000000000000000000000000000110
00000000000000000000000000000110
00000000000000000000000000000110
00000000000000000000000000000110
00000000000000000000000000000110
00000000000000000000000000000000
00000000000000000000000110000000
00000000000000000000000000000000
00000000000001111111100000000000
p0000000000011000000100000000000
000000000000000e0000110000000000
11111111111111111111111111111111
11111111111111111111111111111110
11111111111111111111111111111110
11111111111111111111111111111110
11111111111111111111111111111110
11111111111111111111111111111110
11111111111111111111111111111110
11111111111111111111111111111110
11111111111111111111111111111110
11111111111111111111111111111110
11111111111111111111111111111110
