100000000000000000000000000000
100000000000000000000000000001
100000000000000000000000000000
100000000000000000000000000001
100000000000000000000000000000
100000000000000000000000000000
10000000000000000000e000000000
10000000000000000000e000000000
10000000000000000000e000000000
100000000000000000001000000000
000000000000000000011100000000
000000000110000000001000000000
000000000000000000111110000011
000000001111000000001000000011
111111111111111111111111111111
111111111111111111111111111111
111111111111111111111111111111
111111111111111111111111111111
111111111111111111111111111111
111111111111111111111111111111
111111111111111111111111111111
111111111111111111111111111111
111111111111111111111111111111
111111111111111111111111111111
111111111111111111111111111111