101000000000000000000000000
101000000000000000000000000
101000000000000000000000000
101000000000000000000000000
101000000000000000000000000
101000000000000000000000000
101000000000000000000000000
101000000000000000000000000
101000000000000000000000000
000000000000000000001000000
000000000000000000011100000
000000000110000000001000000
000000000000000000111110000
000000001111000000001000000
111111111111111111111111111
111111111111111111111111111
111111111111111111111111111
111111111111111111111111111
111111111111111111111111111
111111111111111111111111111
111111111111111111111111111
111111111111111111111111111
111111111111111111111111111
111111111111111111111111111
111111111111111111111111111