000000000000000000000000000000000
000000000000001110000000000000000
000000000001001000000000000000000
000000000001001000000000000000000
000000000001111111000000000000000
000000000000001001000000000000000
000000000000001001000000000000000
000000000000111000000000000000000
000000000000000000001000000000000
000000000000000000011100000000000
000000000110000000001000000000000
000000000000000000111110000011110
000000001111000000001000000011110
111111111111111111111111111111111
111111111111111111111111111111111
111111111111111111111111111111111
111111111111111111111111111111111
111111111111111111111111111111111
111111111111111111111111111111111
111111111111111111111111111111111
111111111111111111111111111111111
111111111111111111111111111111111
111111111111111111111111111111111
111111111111111111111111111111111