100000000000000000000000000000000
100000000000000000000000000000001
100000000000000000000000000000000
100000000000000000000000000000001
100000000000000000000000000000000
100000000000000000000000000000001
100000000000000000000000000000000
100000000000000000000000000000001
100000000000000000000000000000000
100000000000000000001000000000000
000000000000000000011100000000000
000000000110000000001000000000000
000000000000000000111110000011110
000000001111000000001000000011110
111111111111111111111111111111111
111111111111111111111111111111111
111111111111111111111111111111111
111111111111111111111111111111111
111111111111111111111111111111111
111111111111111111111111111111111
111111111111111111111111111111111
111111111111111111111111111111111
111111111111111111111111111111111
111111111111111111111111111111111
111111111111111111111111111111111