000000000000000000000000000000000
000000000000000000000000000000001
000000000000000000000000000000000
000000000000000000000000000000001
000000000000000000000000000000000
000000000000000000000000000000001
000000000000000000000000000000000
000000000000000000000000000000000
000000000000000000000000000001010
000000000000000000000001100000000
000000000000000000000000000000000
000000000000000000000000000000000
000000000000000000010000000000000
000000000000000000011000000000000
111111111111111111111111111111111
111111111111111111111111111111111
111111111111111111111111111111111
111111111111111111111111111111111
111111111111111111111111111111111
111111111111111111111111111111111
111111111111111111111111111111111
111111111111111111111111111111111
111111111111111111111111111111111
111111111111111111111111111111111
111111111111111111111111111111111