0000000000000000000000000000000000000
0000000000000000000000000000000000000
0000000000000000000000000000000000000
0000000000000000000000000000000000000
0000000000000000000000000000000000000
0000000000000000000000000000000000000
00000000000000e0000000000000000000000
0000000000000000000000000000000000000
0000000000000000000000000000000000000
000000002222222222222220000000e000000
2200000000000000000000000000000000000
00000000000e0000000000000000000000000
2222220000000000000000220000000000000
2222222222222222222222221100000000000
1111111111111111111111111111111111111
1111111111111111111111111111111111111
1111111111111111111111111111111111111
1111111111111111111111111111111111111
1111111111111111111111111111111111111
1111111111111111111111111111111111111
1111111111111111111111111111111111111
1111111111111111111111111111111111111
1111111111111111111111111111111111111
1111111111111111111111111111111111111
1111111111111111111111111111111111111
